1 1 1 1 1 1 1 1 1 1 1 1 1 1 1 1 1 1 1 1 1 1 1 1 1 1 1 1 1 1 1 1 1 1 1 1 1 1 1 1 
1 1 1 1 1 1 1 1 1 1 1 1 1 1 1 1 1 1 1 1 1 1 1 1 1 1 1 1 1 1 1 1 1 1 1 1 1 1 1 1 
1 1 0 0 0 0 0 0 0 0 0 0 0 0 0 0 0 0 0 0 0 0 0 0 0 0 0 0 0 0 0 0 0 0 0 0 0 0 1 1 
1 1 0 1 1 1 1 3 3 3 1 3 1 1 1 3 1 1 1 3 1 1 1 1 3 1 1 1 3 1 3 3 3 1 1 1 1 0 1 1
1 1 0 1 1 1 1 1 1 1 1 1 1 1 1 1 1 1 1 1 1 1 1 1 1 1 1 1 1 1 1 1 1 1 1 1 1 0 1 1
1 1 0 1 1 2 2 2 2 2 2 2 2 2 2 2 2 2 2 2 2 2 2 2 2 2 2 2 2 2 2 2 2 2 2 1 1 0 1 1
1 1 0 1 1 2 1 1 1 1 1 1 1 1 1 1 1 1 1 1 1 1 1 1 1 1 1 1 1 1 1 1 1 1 2 1 1 0 1 1
1 1 0 1 1 2 1 1 1 1 3 1 1 1 1 1 1 3 1 1 1 3 1 1 1 1 1 1 3 1 1 1 1 1 2 1 1 0 1 1
1 1 0 1 1 2 1 1 1 1 1 3 1 1 1 1 1 1 1 1 1 1 1 1 1 1 1 3 1 1 1 1 1 1 2 1 1 0 1 1
1 1 0 1 1 2 1 1 1 3 1 1 1 1 1 1 1 2 2 2 2 2 1 1 1 1 1 1 1 3 1 1 1 1 2 1 1 0 1 1
1 1 0 1 1 2 1 1 1 1 1 1 1 1 1 1 1 2 1 1 1 2 1 1 1 1 1 1 1 1 1 1 1 1 2 1 1 0 1 1
1 1 0 1 1 2 1 1 1 2 2 2 1 1 1 1 1 2 1 1 1 2 1 1 1 1 1 2 2 2 1 1 1 1 2 1 1 0 1 1
1 1 0 1 1 2 1 1 1 10 2 2 1 1 1 1 3 2 1 1 1 2 3 1 1 1 1 10 2 2 1 1 1 1 2 1 1 0 1 1
1 1 0 1 1 2 1 1 1 2 2 2 1 1 1 1 1 2 1 1 1 11 1 1 1 1 1 2 2 2 1 1 1 1 2 1 1 0 1 1
1 1 0 1 1 2 1 1 1 1 1 1 1 1 1 1 1 2 1 1 1 2 1 1 1 1 1 1 1 1 1 1 1 1 2 1 1 0 1 1
1 1 0 1 1 2 1 1 1 1 1 1 1 1 3 1 1 2 1 1 1 2 1 1 3 1 1 1 1 1 1 1 1 1 2 1 1 0 1 1
1 1 0 1 1 2 1 1 1 1 1 1 1 1 1 1 3 2 1 1 1 2 3 1 1 1 1 1 1 1 1 1 1 1 2 1 1 0 1 1
1 1 0 1 1 2 1 1 1 1 1 1 1 3 1 1 1 2 1 1 1 2 1 1 1 3 1 1 1 1 1 1 1 1 2 1 1 0 1 1
1 1 0 1 1 2 1 1 1 1 1 1 1 1 1 1 1 2 1 1 1 2 1 1 1 1 1 1 1 1 1 1 1 1 2 1 1 0 1 1
1 1 0 1 1 2 1 1 3 1 1 1 1 1 1 1 1 2 1 1 1 2 1 1 1 1 1 1 1 1 1 3 1 1 2 1 1 0 1 1
1 1 0 1 1 2 1 1 1 3 1 3 1 2 2 2 1 2 1 1 1 2 1 2 2 2 1 1 3 1 3 1 1 1 2 1 1 0 1 1
1 1 0 1 1 2 1 1 1 1 1 1 1 2 2 11 1 2 1 1 1 2 1 2 2 11 1 1 1 1 1 1 1 1 2 1 1 0 1 1
1 1 0 1 1 2 1 1 1 1 1 1 1 2 2 2 1 2 1 1 1 2 1 2 2 2 1 1 1 1 1 1 1 1 2 1 1 0 1 1
1 1 0 1 1 2 1 1 1 1 1 1 1 1 1 1 1 2 2 2 2 2 1 1 1 1 1 1 1 1 1 1 1 1 2 1 1 0 1 1 
1 1 0 1 1 2 1 1 1 1 1 1 1 1 1 1 1 1 1 1 1 1 1 1 1 1 1 1 1 1 1 1 1 1 2 1 1 0 1 1
1 1 0 1 1 2 2 2 2 2 2 2 2 2 2 2 2 2 2 10 2 2 2 2 2 2 2 2 2 2 2 2 2 2 2 1 1 0 1 1
1 1 0 1 1 1 1 1 1 1 1 1 1 1 1 1 1 1 1 1 1 1 1 1 1 1 1 1 1 1 1 1 1 1 1 1 1 0 1 1
1 1 0 1 1 1 1 1 1 1 1 1 1 1 1 1 1 1 1 1 1 1 1 1 1 1 1 1 1 1 1 1 1 1 1 1 1 0 1 1
1 1 0 0 0 0 0 0 0 0 0 0 0 0 0 0 0 0 0 0 0 0 0 0 0 0 0 0 0 0 0 0 0 0 0 0 0 0 1 1
1 1 1 1 1 1 1 1 1 1 1 1 1 1 1 1 1 1 1 1 1 1 1 1 1 1 1 1 1 1 1 1 1 1 1 1 1 1 1 1 
1 1 1 1 1 1 1 1 1 1 1 1 1 1 1 1 1 1 1 1 1 1 1 1 1 1 1 1 1 1 1 1 1 1 1 1 1 1 1 1 
