1 1 1 1 1 1 1 1 1 1 1 1 1 1 1 1 1 1 1 1 1 1 1 1 1 1 1 1 1 1 1 1 1 1 1 1 1 1 1 1 
1 1 1 1 1 1 1 1 1 1 1 1 1 1 1 1 1 1 1 1 1 1 1 1 1 1 1 1 1 1 1 1 1 1 1 1 1 1 1 1 
1 1 0 0 0 0 0 0 0 0 0 0 0 0 0 0 0 0 0 0 0 0 0 0 0 0 0 0 0 0 0 0 0 0 0 0 0 0 1 1 
1 1 0 4 1 1 1 2 2 2 0 1 1 1 1 1 1 1 1 1 1 1 3 0 3 1 1 1 1 1 1 3 1 1 1 1 1 0 1 1
1 1 0 1 4 1 2 2 2 3 0 1 3 1 1 1 1 1 4 3 1 1 1 0 1 1 1 1 3 1 1 1 1 4 3 4 1 0 1 1
1 1 0 1 1 2 2 2 2 0 0 1 4 3 1 1 0 1 1 1 3 1 1 0 1 0 0 1 4 1 1 0 1 1 1 3 3 0 1 1
1 1 0 1 2 2 2 2 0 0 1 1 1 1 1 1 1 0 1 1 1 1 0 1 1 0 1 1 1 1 0 1 0 1 1 3 3 0 1 1
1 1 0 2 2 2 2 0 0 1 1 1 1 1 1 1 3 1 0 1 3 1 0 1 0 1 4 1 0 0 3 3 1 0 1 1 1 0 1 1
1 1 0 2 2 3 0 1 1 1 1 1 1 0 1 1 1 1 1 0 0 1 0 1 1 1 1 3 1 1 4 1 1 1 0 1 1 0 1 1
1 1 0 2 2 0 0 1 1 1 1 1 1 1 0 0 1 1 1 1 1 1 1 0 0 1 1 1 1 3 1 0 1 3 0 1 1 0 1 1
1 1 0 2 0 0 1 1 1 1 0 1 1 1 1 0 1 1 1 4 1 1 1 1 1 0 1 1 1 1 1 0 1 1 0 3 1 0 1 1
1 1 0 2 0 0 1 1 1 3 1 1 1 1 1 0 1 1 1 1 4 0 0 1 1 1 0 0 1 3 1 1 1 1 1 0 1 0 1 1
1 1 0 2 0 1 1 3 1 3 4 1 1 3 1 3 1 3 1 1 1 1 1 1 3 1 1 1 0 1 1 1 1 1 1 1 1 0 1 1
1 1 0 2 0 1 1 1 1 1 4 1 1 1 4 1 4 3 0 1 3 1 1 1 3 1 1 1 1 0 0 0 1 1 1 0 4 0 1 1 
1 1 0 2 0 1 1 0 0 0 0 0 1 1 1 1 1 3 1 1 1 1 1 1 4 0 1 1 1 1 1 1 1 1 1 0 0 0 1 1
1 1 0 2 0 1 1 3 1 1 0 1 1 1 0 0 1 1 1 3 1 1 1 1 1 1 0 1 1 3 1 1 1 1 3 1 1 0 1 1
1 1 0 2 0 0 1 1 1 1 1 1 1 1 1 1 1 1 1 1 1 3 0 1 1 1 1 1 1 1 1 3 1 1 1 1 1 0 1 1
1 1 0 2 4 0 1 3 1 1 1 3 1 1 1 1 1 0 1 1 4 0 1 1 1 1 3 1 1 1 1 1 1 1 1 1 1 0 1 1
1 1 0 2 0 0 1 1 1 1 1 3 1 1 1 0 0 1 1 1 0 1 1 3 1 0 0 3 1 1 1 1 1 0 1 1 1 0 1 1
1 1 0 2 0 1 1 4 1 1 1 1 3 1 3 1 1 1 3 1 0 1 1 1 1 1 1 0 3 1 1 0 0 1 1 1 1 0 1 1
1 1 0 2 0 1 1 1 0 1 1 1 1 1 4 1 1 1 1 1 1 3 1 1 1 1 1 1 1 1 1 0 1 1 1 3 3 0 1 1
1 1 0 2 0 1 1 3 1 0 1 1 1 1 1 1 3 1 1 1 1 1 1 0 3 1 1 1 1 1 1 0 1 1 1 1 1 0 1 1
1 1 0 2 0 0 1 1 1 1 1 1 1 0 1 1 1 3 1 1 1 1 1 0 1 3 1 1 1 3 0 1 1 3 1 1 1 0 1 1
1 1 0 2 2 0 0 1 1 1 1 3 1 0 1 1 1 1 1 0 1 1 1 0 1 1 1 1 3 1 0 1 1 3 1 1 1 0 1 1
1 1 0 0 2 2 0 0 1 1 1 3 1 0 1 1 1 1 0 1 1 1 0 4 1 1 1 1 1 4 1 0 1 1 1 3 1 0 1 1
1 1 0 1 0 2 2 0 0 1 1 4 1 1 1 3 1 0 3 1 1 0 1 1 3 1 0 0 1 4 1 0 1 1 6 1 1 0 1 1
1 1 0 1 1 2 1 1 0 0 1 1 1 1 1 1 1 1 1 4 0 1 1 3 3 1 1 1 1 1 1 0 1 1 1 3 1 0 1 1
1 1 0 1 1 2 0 1 1 1 1 1 1 1 1 1 1 1 3 1 1 1 1 1 1 1 1 1 1 1 0 1 4 1 1 1 1 0 1 1
1 1 0 0 0 0 0 0 0 0 0 0 0 0 0 0 0 0 0 0 0 0 0 0 0 0 0 0 0 0 0 0 0 0 0 0 0 0 1 1
1 1 1 1 1 1 1 1 1 1 1 1 1 1 1 1 1 1 1 1 1 1 1 1 1 1 1 1 1 1 1 1 1 1 1 1 1 1 1 1 
1 1 1 1 1 1 1 1 1 1 1 1 1 1 1 1 1 1 1 1 1 1 1 1 1 1 1 1 1 1 1 1 1 1 1 1 1 1 1 1 